Name	Purpose
Francis and Sons	Automated 4thgeneration initiative for seize distributed synergies
Shelton PLC	Inverse leadingedge model for deliver 24/365 content
Calhoun LLC	Reverse-engineered even-keeled circuit for drive clicks-and-mortar niches
Fernandez, George and Hunt	Virtual heuristic paradigm for benchmark B2B web-readiness
Johnston-Palmer	Reactive fresh-thinking knowledge user for scale distributed vortals
Reyes, Wilson and Lyons	Operative zero-defect database for mesh viral channels
Johnson-Miller	Monitored maximized policy for evolve 24/7 communities
Lucas, Brown and Adkins	Future-proofed coherent Graphical User Interface for repurpose strategic deliverables
Mclaughlin and Sons	Intuitive exuding encoding for envisioneer customized e-tailers
Riddle LLC	Innovative full-range time-frame for orchestrate web-enabled users
Rogers, Howell and Harvey	Open-architected disintermediate project for evolve mission-critical methodologies
Castillo-Schroeder	Vision-oriented national secured line for productize turn-key convergence
Johnson-Wilson	Grass-roots neutral focus group for optimize granular infrastructures
Nelson-Brown	Function-based systemic contingency for re-contextualize visionary mindshare
Davis-Flores	Up-sized object-oriented superstructure for aggregate bricks-and-clicks channels
Johnson-Osborne	Reverse-engineered bandwidth-monitored extranet for synergize customized metrics
Foley, Mitchell and Davis	Fundamental bifurcated capability for transition B2C architectures
Sherman-Russo	Cloned bi-directional system engine for seize ubiquitous technologies
Wade, Peck and Rose	Expanded reciprocal matrices for iterate web-enabled mindshare
Stevens-Hill	Right-sized human-resource middleware for productize enterprise experiences
Hughes-Medina	Multi-lateral intermediate encryption for morph viral schemas
Haynes, Young and Patel	Progressive background middleware for innovate cross-media niches
Beard, Duke and Martin	Customer-focused web-enabled contingency for cultivate efficient interfaces
Perry-Fox	Realigned fault-tolerant system engine for re-intermediate cross-media schemas
Mercado PLC	Re-contextualized multi-state superstructure for utilize scalable content
Willis, Martinez and Smith	Switchable regional website for disintermediate cross-media e-business
Vasquez, Garcia and Fletcher	Exclusive disintermediate algorithm for seize 24/365 web-readiness
Young-Williams	Multi-tiered local system engine for cultivate turn-key markets
Obrien, Munoz and Jenkins	Cross-group next generation implementation for synthesize sexy partnerships
Owens, Callahan and Summers	Synergistic mobile product for brand world-class systems
Davis LLC	Optional composite paradigm for deploy B2B channels
Morgan-Franklin	Total fresh-thinking task-force for innovate mission-critical interfaces
Lang-Frank	Multi-lateral homogeneous solution for facilitate user-centric relationships
Gross-Jackson	Intuitive local neural-net for streamline customized markets
Smith LLC	Sharable zero administration definition for monetize integrated portals
Carroll, Mann and Weeks	Self-enabling hybrid service-desk for seize rich platforms
Walker and Sons	Open-architected 3rdgeneration instruction set for generate turn-key relationships
Moody Group	Configurable multimedia methodology for benchmark e-business models
Walker-Johnson	User-friendly incremental model for facilitate back-end technologies
Flowers, Pollard and Henry	Up-sized grid-enabled capacity for orchestrate synergistic supply-chains
Carter, Parrish and Gonzalez	Distributed even-keeled contingency for transform enterprise e-business
Vargas and Sons	Focused modular algorithm for optimize dot-com architectures
Gonzalez-Long	Monitored mission-critical budgetary management for envisioneer killer partnerships
Martin LLC	Realigned user-facing capacity for enhance open-source niches
Casey Inc	Synchronized systematic solution for empower efficient deliverables
Clark Group	Customer-focused 24/7 portal for transform strategic portals
Wright LLC	Triple-buffered 6thgeneration artificial intelligence for grow 24/7 vortals
Fox, Adams and Johnson	User-centric user-facing access for monetize web-enabled systems
Franklin, Flynn and Bell	Pre-emptive secondary projection for re-contextualize sticky e-markets
Davis, Valdez and Keller	Ameliorated client-server architecture for matrix real-time initiatives
